data	labels
won Coalition Elections on.	Finish_competition
setting the SEBI of.	Intentionally_create
took discrimination attribute and.	Event
depicted Baptists unintelligent as.	Communicate_categorization
are none use in.	__NOFRAME__
create UPM start prior_to.	Intentionally_create
talked Maruyama seeing of.	Statement
took Rutelli example as.	Taking
raised people issue after.	Causation
includes which payments None.	Inclusion
proceeded program phases through.	Process_continue
applied term shapes to.	Using
returned people period during.	Arriving
chosen vocabulary languages among.	Choosing
placed he identity on.	Placing
engaged that activities with.	Intentionally_act
was Norway was but.	__NOFRAME__
housed that woman None.	Containing
includes communications programs along_with.	Inclusion
won UPV re-elected and.	Getting
say I you to.	Statement
asked party purge for.	Request
offers men programs None.	Offering
has thread level None.	Possession
serve Members July on.	Assistance
followed this Rossi under.	Relative_time
organizes who unionizes or.	__NOFRAME__
lost Faulkner formed and.	Finish_competition
allows This camera None.	Grant_permission
held groups belief None.	Containing
is selection is and.	__NOFRAME__
wrote Levin President to.	Statement
forced resources result as.	Causation
lacerated surface surface like.	__NOFRAME__
were % 64 from.	__NOFRAME__
computing IT government by.	__NOFRAME__
saved who damnation from.	__NOFRAME__
insist it morality on.	Statement
stated % rise None.	Statement
constituted counties territory None.	Communicate_categorization
expelled who 1987 in.	Removing
occur UPD happen or.	Event
operated church camp in.	Operating_a_system
included sounds system in.	Inclusion
used term Life in.	Using
known Uniontown Road for.	Awareness
defined square lie and.	Categorization
has functor adjoint None.	Possession
rebutted UCS saying by.	__NOFRAME__
took Students Cung among.	Bringing
came It being into.	Arriving
formed It offshoot as.	Coming_to_be
had % living None.	Possession
include tools integration None.	Inclusion
started UpT autumn in.	Activity_start
selected key declared and.	Choosing
caricature the anarchist of.	__NOFRAME__
are unionids sex of.	__NOFRAME__
called coalition February in.	Request
dissolved It II after.	Coming_to_be
became union seen and.	Becoming
are which % around.	__NOFRAME__
opened vineyard 1993 in.	Secrecy_status
had that sets None.	Possession
took It Revolution in.	Conquering
known He tale for.	Awareness
are groups September as_of.	__NOFRAME__
provides OWL constructs None.	Supply
had It wanted and.	Possession
arise models analysis in.	Coming_to_be
embraced Souls pluralism in.	Adopt_selection
chosen Eisenhower led but.	Choosing
formed Pact members by.	Coming_to_be
graduated members Liberals from.	__NOFRAME__
includes This quantification None.	Inclusion
rejected Laurier fears and.	Respond_to_proposal
called what end until.	Request
share pair y None.	__NOFRAME__
support Italians spectrum in_place_of.	Taking_sides
founded party February in.	Intentionally_create
consists structure languages in.	__NOFRAME__
administers that domains None.	Leadership
rejected voters Scotland for.	Respond_to_proposal
did they project at.	Intentionally_act
merged which 2007 in.	Cause_to_amalgamate
placed subjects death until.	Placing
listed which Commission in.	__NOFRAME__
became it 2002 in.	Becoming
announced Unit page on.	Statement
succeeded he Jaeken None.	Success_or_failure
feature Vuelvo songs unlike.	Inclusion
acted King overlordship under.	Performers_and_roles
returned queen Hungary to.	Arriving
visited Malatesta States in.	Arriving
criticized USS having and.	Judgment_communication
making F-104 manoeuvres None.	Intentionally_create
published history 2000 in.	__NOFRAME__
produce use estimates None.	Manufacturing
run Transactions recovery with.	Leadership
immigrated Boepple found and.	__NOFRAME__
recognized CBD highlighted and.	Becoming_aware
forced he abdication into.	__NOFRAME__
found search planes in.	Becoming_aware
founded organ July on.	Intentionally_create
defines voltage bit None.	Categorization
consists basis price of.	__NOFRAME__
founded Corporation registered and.	Intentionally_create
continued that 1944 to.	Activity_ongoing
have synthesisers saw None.	Possession
removed requirement statement None.	Removing
disbanded ASSR joined and.	__NOFRAME__
performed works Plaschka by.	Intentionally_act
joined former Party None.	Becoming_a_member
used congregation 1946 until.	Using
advocate who policies None.	__NOFRAME__
has church Seminaries None.	__NOFRAME__
established Polskie Union by.	Intentionally_create
served she years for.	Assistance
remains it leave and.	State_continue
claimed paper crore and.	Statement
Got I What None.	Getting
gracilis Erpetosuchus Erpetosuchus None.	__NOFRAME__
sold Unique produced and.	Commerce_sell
has that element None.	Possession
includes It Unison from.	Inclusion
created Cissé UDR-Tabbat on.	Intentionally_create
allow membrane cell into.	Grant_permission
deposed he leader as.	Change_of_leadership
referred drinks used but.	Sending
takes Union Communists from.	Removing
known units Unit as.	Being_named
said It maintained but.	Statement
simplified features resolution None.	__NOFRAME__
have We time None.	Possession
occupied Tablets debate with.	Residence
ruled Strayhorn May in.	Leadership
offers Seller price at.	Offering
involved organization is in.	Participation
named Uniontown Places None.	Being_named
became leader resigned and.	Becoming
served of Minister as.	Assistance
expounded Dawkins view None.	Statement
had sitcom episode None.	Possession
serves money role in.	Assistance
have UUA found but.	Possession
released group November on.	Releasing
received unit 1945 in.	Receiving
surapassed party Veneta None.	__NOFRAME__
won UDEMO seats out_of.	Finish_competition
resigned Borger July in.	Quitting
united Acts acts through.	Cause_to_amalgamate
gain instructions use None.	Getting
announced Photo February on.	Statement
preceded It succeeded and.	Relative_time
produced album directed and.	Manufacturing
disclaimed office proposal for.	__NOFRAME__
released they reader in.	Releasing
became UDF merger to.	Becoming
applies Sturla Ilmur to.	Using
found inspiration experiences as.	Locating
formed Union September in.	Coming_to_be
referenced programmer code in.	__NOFRAME__
serves Unison markets in.	Assistance
published Imaledih organ as.	__NOFRAME__
reported district 2010 in.	Statement
maintains Unit covert None.	Activity_ongoing
produced which banner under.	Manufacturing
adopted facility 1941 in.	Adopt_selection
won which seats None.	Getting
were males females for.	__NOFRAME__
is structure moment at.	__NOFRAME__
invited who them None.	Request
became Corporation launched and.	Becoming
provides OS environment None.	Supply
has Liberal history None.	Possession
choose Federation him because_of.	Choosing
included businesses plow and.	Inclusion
joined he League for.	Becoming_a_member
opened Uniqlo Glorietta after.	Secrecy_status
laureates petition science in.	__NOFRAME__
uses cycle enzymes None.	Using
attain UCD % with.	__NOFRAME__
was It ended until.	__NOFRAME__
criticised Kumar issuing for.	Judgment_communication
has ULD list None.	Possession
formed Unionists parliaments in.	Creating
performed she 21 on.	Intentionally_act
created It renamed and.	Intentionally_create
stood group merged and.	Being_located
ordered Unisys 1991 in.	Request
entered whom Revolution before.	Arriving
enables which mussel None.	__NOFRAME__
attempted which success with.	Attempt
held UCS briefings in.	Containing
dissolved house set and.	Coming_to_be
adopted church 1912 in.	Adopt_selection
publishing Union monographs None.	__NOFRAME__
take meetings place alongside.	Event
accepted Juppé failed but.	Respond_to_proposal
no. orders April from.	__NOFRAME__
left UDC side on.	Departing
tasked that escort with.	__NOFRAME__
provides station pumper for.	Supply
elected Htay one None.	Change_of_leadership
is It list on.	__NOFRAME__
held trial December in.	Containing
were heads exception with.	__NOFRAME__
graduated Masahiro 1979 in.	__NOFRAME__
won Union appointed and.	Getting
made ULDY <br /> including.	Causation
held demonstration seat in_front_of.	__NOFRAME__
provides It APIs None.	Supply
was work cast and.	__NOFRAME__
based paintings designs on.	__NOFRAME__
leds Urzicens end towards.	Leadership
acquired company continues but.	Getting
released Music 2012 in.	Releasing
adopted she assistance for.	Adopt_selection
give additions cost at.	Giving
became Dion France in.	Becoming
used prisoners studies in.	Using
maintained party militia in.	Statement
secured SNP Salmond under.	Getting
signed states three such_as.	Sign_agreement
grows constant function as.	Change_position_on_a_scale
condemned threat released and.	Judgment_communication
took Tomlinson result with.	Bringing
defined everything done but.	Categorization
named It Erriapus after.	Appointing
located headquarters Ecuador in.	Being_located
suggested Ward recruitment None.	Statement
known race sponsored and.	Being_named
Dream Championship try and.	__NOFRAME__
identifies that tuple None.	Verification
formed UDEUR Campania in.	Creating
elected Raynor president None.	Change_of_leadership
approved Statutes 28 on.	Grant_permission
certified it Gold None.	Verification
used that languages in.	Using
holds result constant for.	Containing
used It Flesh in.	Using
moved that truck with.	Motion
take Those Westminster at.	Taking
represented Erra Malaysia None.	Communicate_categorization
obtained Africa Mandate with.	Getting
returned election majority None.	Arriving
lived They 1637 until.	Residence
remain most gains despite.	State_continue
made cast professionals of.	Causation
renovated compartments Wi-Fi with.	__NOFRAME__
took he VIII at.	Bringing
intersect who overlap and.	__NOFRAME__
contains pint example for.	Inclusion
maintained UAW stemmed but.	Statement
took party measures None.	Removing
was that 1952 from.	__NOFRAME__
consider who themselves None.	Categorization
were churches time in.	__NOFRAME__
bursting field seams at.	__NOFRAME__
quit who party None.	Quitting
founded Wise Conference in.	Intentionally_create
operated line Stockholm from.	Operating_a_system
won party 13 None.	Finish_competition
took referendum 18 on.	Event
rejects advocates federalism None.	Respond_to_proposal
add UDS liquid to.	Statement
increased which sales None.	Cause_change_of_position_on_a_scale
won it votes None.	Getting
visualized asymmetry dress in.	__NOFRAME__
lie which south to.	Being_located
using foundation technology None.	Using
founded It merged and.	Intentionally_create
signed It Deluge during.	Sign_agreement
moved Blackwells house into.	Motion
remained price example for.	State_continue
has process roots None.	Possession
owns who it and.	Possession
creates system loads as.	Creating
called Unit fatalities and.	Request
were they control under.	__NOFRAME__
came wagons filled and.	Arriving
decreed Jogaila 17 on.	__NOFRAME__
manifested that action in.	__NOFRAME__
playing supplies leagues for.	Performers_and_roles
allow standardizing Beaver for.	Permitting
given Association acts under.	Giving
has PQ length None.	Possession
depicted figures garments in.	Communicate_categorization
continue War decades for.	Process_continue
founded which 10 on.	Intentionally_create
became UEP extended and.	Becoming
is population peak about.	__NOFRAME__
played Craven team for.	Performers_and_roles
reached which No. None.	Arriving
divided community support over.	Separating
were ideas liked and.	__NOFRAME__
formed Erprobungskommando Rechlin-Roggenthin in.	Coming_to_be
resists party regions in.	Taking_sides
reached membership 250 None.	Arriving
recruited Members moshavim from.	__NOFRAME__
is solution unions for.	__NOFRAME__
stood Skowronek assembly to.	Being_located
form operations principles None.	Creating
find I society in.	Becoming_aware
chosen Wladislaus Elbow-high in.	Choosing
opposed UAW committed and.	Taking_sides
won It seat None.	Getting
occurred outbreaks cities in.	Event
changed Unipalm 2006 in.	Undergo_change
invited Veil 2005 in.	Request
find people website on.	Becoming_aware
have units require and.	Have_associated
lived they way in.	Residence
formed Dellai List in.	Coming_to_be
resigned Aziz winning after.	Quitting
found Ofotbanen operating and.	Locating
allied party election for.	__NOFRAME__
expelled union union from.	Removing
led reforms creation to.	Causation
hinted Le Book in.	__NOFRAME__
received SPS failed and.	Receiving
launched site search with.	Shoot_projectiles
finds he surprises None.	Locating
opposed they belief but.	Taking_sides
based referral obligation on.	__NOFRAME__
maintains It Singapore in.	Activity_ongoing
is This extent to.	__NOFRAME__
sends referee have and.	Sending
cleared Luca inciting of.	Removing
edited Emancipation publications None.	__NOFRAME__
access you displays None.	__NOFRAME__
composed Camilleri piece None.	Text_creation
expelled Ichat differences for.	Removing
provided Maternalism backdrop None.	Supply
diverging variance t. with.	__NOFRAME__
found file </code> in.	Locating
had Berkman believed but.	Possession
participates Union organization in.	Participation
refers term events to.	Sending
allege they Virginia on.	Statement
returned members parties to.	Arriving
used which predictor as.	Using
succeeded CEO 2004 in.	Success_or_failure
supported UUA supported and.	Taking_sides
try Championship reputation None.	Attempt
opposed parties Democracy for.	Taking_sides
defines file macros None.	Categorization
made It nationals of.	Causation
is series production in.	__NOFRAME__
had % householder None.	Possession
united Lithuania army with.	Cause_to_amalgamate
reached club Divisione None.	Arriving
constructed addition 1920 in.	Building
found Smuts House in.	Locating
contains </math> <math> since.	Inclusion
regard We essential as.	Categorization
belonged they party to.	Possession
lost society scores including.	Finish_competition
has Unionbank company according_to.	Possession
been which symbols without.	__NOFRAME__
takes Medal Medal before.	Removing
oversaw she construction as.	__NOFRAME__
be status what None.	__NOFRAME__
denounced It nation-state to.	Judgment_communication
were families census as_of.	__NOFRAME__
asked designers/labels Designers for.	Request
continued they implementing in_addition_to.	Activity_ongoing
integrated it support with.	__NOFRAME__
called building Church None.	Being_named
